Словарь - список слов, правельное написание слов

Индифферентно - безразлично
Нонсенс - бессмыслица
Альков - углубление для кровати
Ягдташ - сумка из кожи
Аморфный Хим., минер. Не имеющий кристаллического строения
Дебелый - упитанный
Эпитафия - Надгробная, намогильная надпись.
Еретик - не верующий человек

Филигранный - совершённый с большим мастерством, тщательно искусно
Априори - знание, полученное до опыта и независимо от него
Аггравация - преувеличение больным какого-либо симптома или болезненного состояния
Нигилист - тот, кто трицает общепринятые ценности
Бутафория - Предметы, составляющие обстановку играемых пьес
Менталитет - склад ума, совокупность умственных, эмоциональных, культурных особенностей, ценностных ориентаций и установок, присущих социальной или этнической группе, нации, народу, народности.
Серпантин - Длинная узкая разноцветная бумажная лента
Сюр - 
Эльдорадо - Страна сказочных богатств и чудес
Коллаборация - совместная работа
Кильватер - Струя позади идущего судна
Променад - прогулка
Диссонанс - противоречие чему-либо, вносящее разлад, нарушая гармонию
Визави, тет-а-тет 
Авангард - Отряд войска, флота, находящийся впереди главных сил
Арьергард - Часть войска, следующая позади главных сил в походном движении
Нелицеприятный - неприятный, грубый, жёсткий, обидный
Ипохондрия - Нервное расстройство, возникающее на почве болезненного страха перед заболеваниями
Космополит - сторонник идеи мирового гражданства, тот, кто считает весь мир своим отечеством
Сноб - Человек, поведение и вкусы к-рого определяются стремлением не отстать от моды и постоянно придерживаться манер буржуазно-аристократического круга
Тривиальный - лишенный новизны, свежести; неоригинальный, банальный
Эскапизм - 
Панацея - лекарство от всего